%%%%%%%%%%%%%%%%%%%%%%
%                    %
%                   $%
% B$$$$$$$R$$$$$$$$$B%
%%%%%%%%%%%%%%%%%%%%%%