%%%%%%%%%%%%%%%%%%%%%%
%    $$              %
%   $  $             %
%    $$              %
%       $  %         %
%      $$$           %
%     $$B$$          %
%      $$$           %
%       $           $%
%                   $%
%%%%%%%%%%%%%%%%%%%%%%